XXXXXXXXXXXXXXX
P    X     X  X
XXXX X  XXXXX X
X  X    X   X X
X  X  X  XX   X
X  X XXX X  XXX
X     X  XX X X
X  XXXXXXX  X X
XX X    XX    X
X  X XX  X X  X
XX   XX  X XX X
X  XXX X X   XX
XX X   X X X  X
X    X X   XX B
XXXXXXXXXXXXXXX